Payoff	3 days ago	3 days ago
Tech Mahindra	3 days ago	3 days ago
Acorns	3 days ago	3 days ago
Go Capital	3 days ago	3 days ago
Ink	3 days ago	3 days ago
Sage IT Inc	3 days ago	3 days ago	
PriceSpider - Front End Web Developer	3 days ago	3 days ago
FoxTales	3 days ago	3 days ago
Court Appearance Professionals	3 days ago	3 days ago
DealerSocket	3 days ago	3 days ago
BetterCareMD	3 days ago	3 days ago
AT-TECH	3 days ago	3 days ago
infogain	3 days ago	3 days ago
Ledgent Technology - Front End Engineer	3 days ago	3 days ago
M S International, Inc	3 days ago	3 days ago
KellyMitchell	3 days ago	3 days ago
Fusion of Ideas	3 days ago	3 days ago
Green Street Advisors, Inc. - Junior Web Application Developer	3 days ago	3 days ago
Hart	3 days ago	3 days ago
Continio Software Solutions	3 days ago	3 days ago
PriceSpider	9 days ago	9 days ago
Renesas Electronics America	9 days ago	9 days ago
Samsung Electronics America	9 days ago	9 days ago
Akouba	9 days ago	9 days ago
Zephyr Health	9 days ago	9 days ago
LiveCareer	9 days ago	9 days ago
EDI	9 days ago	9 days ago
Bodyport	9 days ago	9 days ago
Xtreme Consulting Group	9 days ago	9 days ago
PhaseZero Ventures	9 days ago	9 days ago
Intellisoft	9 days ago	9 days ago
Intellis	9 days ago	9 days ago
Signature Consultants	10 days ago	10 days ago
Track Revenue	10 days ago	10 days ago
Airbnb - intern	10 days ago	10 days ago
HP	10 days ago	10 days ago
GE	10 days ago	10 days ago
Wish	10 days ago	10 days ago
PunchAgency	10 days ago	10 days ago
The Climate Corporation	10 days ago	10 days ago
Notable Labs	10 days ago	10 days ago
TrueCar	10 days ago	10 days ago
Cisco	10 days ago	10 days ago
Cyber Coders	10 days ago	10 days ago
Tripping	10 days ago	10 days ago
Tripping.com	10 days ago	10 days ago
VentureLoop	10 days ago	10 days ago
PersistIQ	10 days ago	10 days ago
Academia	10 days ago	10 days ago
Robert Half Technology	10 days ago	10 days ago
Avenue Code	10 days ago	10 days ago
UpCounsel	10 days ago	10 days ago
Confidential Financial Company	10 days ago	10 days ago
The CEI Group	10 days ago	10 days ago
Cureus	10 days ago	10 days ago
stamps.com	10 days ago	10 days ago
produce pay	10 days ago	10 days ago
Dice	10 days ago	10 days ago
Ticketmaster	10 days ago	10 days ago
iSpace	10 days ago	10 days ago
Centerfield Media Frontend Developer	10 days ago	10 days ago
Twist Bioscience	17 days ago	about 1 month ago
gofundme	17 days ago	about 1 month ago
FocusKPI Inc	17 days ago	about 1 month ago
Pillow - Full Stack Software Engineer	17 days ago	about 1 month ago
Blueshift Labs Inc	17 days ago	about 1 month ago
LSQ Funding	17 days ago	about 1 month ago
Beautylish	17 days ago	about 1 month ago
mulesoft	17 days ago	about 1 month ago
Twitch	17 days ago	17 days ago
IXL Learning	17 days ago	17 days ago
IXL	17 days ago	17 days ago
western union	17 days ago	17 days ago
City of San Francisco - Frontend	17 days ago	17 days ago
Delphix	17 days ago	17 days ago
Airbnb	17 days ago	17 days ago
VENTUREAPP	17 days ago	17 days ago
plex	17 days ago	17 days ago
A3 Logistics	17 days ago	17 days ago
cloudcar	17 days ago	17 days ago
Cloud4Wi	17 days ago	17 days ago
apex systems	17 days ago	17 days ago
The Select Group	17 days ago	17 days ago
Byte	17 days ago	17 days ago
Chargeback Gurus	17 days ago	17 days ago
KirkSearch	17 days ago	17 days ago
kforce	17 days ago	17 days ago
Mainz Brady Group	17 days ago	17 days ago
The Armada Group	17 days ago	17 days ago
Magnum Staffing	17 days ago	17 days ago
apn software services	17 days ago	17 days ago
Redfish Technology	17 days ago	17 days ago
Vertisystem	17 days ago	17 days ago
National Software Management	17 days ago	17 days ago
Nucleus10	17 days ago	17 days ago
PlacingIT - web developer	17 days ago	17 days ago
Innerspin	17 days ago	17 days ago
Mobovida - Front End Developer	17 days ago	17 days ago
Genius Sports - Front End Developer	17 days ago	17 days ago
ProducePay	17 days ago	17 days ago
QuickPay	17 days ago	17 days ago
First American	17 days ago	17 days ago
WITS America Corp.	27 days ago	27 days ago
Gap Inc.	27 days ago	27 days ago
Greenhouse	27 days ago	about 1 month ago
icix	27 days ago	about 1 month ago
Linqia	27 days ago	about 1 month ago
Business Wire	27 days ago	about 1 month ago
EarthX	27 days ago	about 1 month ago
Tremor Video, Inc.	27 days ago	about 1 month ago
Liveramp - Full Stack Engineer	27 days ago	about 1 month ago
Pinterest	27 days ago	about 1 month ago
Tier1app	27 days ago	about 1 month ago
CardFree - Software Engineer	27 days ago	about 1 month ago
mavenlink - ruby on rails engineer	27 days ago	about 1 month ago
Disqus - Frontend Engineer	27 days ago	about 1 month ago
EverFi - Full Stack Ruby on Rails Engineer	27 days ago	about 1 month ago
Eva Automation, Inc.	27 days ago	about 1 month ago
goodshop	27 days ago	about 1 month ago
Intercom	27 days ago	about 1 month ago
HireClout - Ruby on Rails Engineer	27 days ago	about 1 month ago
APAR PeopleWorld Software Services Inc	27 days ago	about 1 month ago
education elements	27 days ago	about 1 month ago
Yelp	27 days ago	about 1 month ago
Exabeam	27 days ago	27 days ago
NASA Jet Propulsion Laboratory - Web Developer, Front-End and Full-Stack Development	27 days ago	27 days ago
Nokia - Web Developer	27 days ago	27 days ago
Intercom-Software Engineer(SF)	27 days ago	27 days ago
BFFT of America, Inc.	27 days ago	27 days ago
Prudential	27 days ago	27 days ago
Toptal	27 days ago	27 days ago
John Hancock Digital - Full-Stack Developer (Ruby on Rails)	27 days ago	27 days ago
Opengov	27 days ago	about 1 month ago
Entelo	27 days ago	27 days ago
Nextdoor	27 days ago	27 days ago
NerdWallet - New Grad	27 days ago	27 days ago
Clever	27 days ago	27 days ago
Quantcast	27 days ago	27 days ago
Salesforce	27 days ago	27 days ago
Salesforce - Front End Engineer	27 days ago	27 days ago
Cypress HCM	27 days ago	27 days ago
The Grammarly	27 days ago	27 days ago
Ampush	27 days ago	about 1 month ago
Clicktale	27 days ago	about 1 month ago
Cedexis	27 days ago	about 1 month ago
Meteor	27 days ago	about 1 month ago
Symphony Commerce	27 days ago	about 1 month ago
The Funding Circle	27 days ago	about 1 month ago
SigFig	27 days ago	about 1 month ago
Radian Generation	27 days ago	about 1 month ago
BFFT	27 days ago	about 1 month ago
The Goodshop	27 days ago	about 1 month ago
Fast Dolphin	27 days ago	about 1 month ago
Incusol Inc Software Developer	27 days ago	about 1 month ago
Workday - Software Development Engineer, Intern	27 days ago	27 days ago
StudyBlue	about 1 month ago	about 1 month ago
C3 IoT	about 1 month ago	about 1 month ago
TheRightMargin	about 1 month ago	about 1 month ago
Prism Skylabs - Web Software Engineer	about 1 month ago	about 1 month ago
HouseCanary	about 1 month ago	about 1 month ago
Ohmygreen - Full stack developer	about 1 month ago	about 1 month ago
esurance - react engineering	about 1 month ago	about 1 month ago
NXVL Technology	about 1 month ago	about 1 month ago
JDStrategies	about 1 month ago	about 1 month ago
Glotel Inc	about 1 month ago	about 1 month ago
LifeAssist Technologies	about 1 month ago	about 1 month ago
therightmargin - fullstack engineer	about 1 month ago	about 1 month ago
Rabbit, Inc.	about 1 month ago	about 1 month ago
3scale	about 1 month ago	about 1 month ago
Wrap Media	about 1 month ago	about 1 month ago
Shipt	about 1 month ago	about 1 month ago
Involver	about 1 month ago	about 1 month ago
FIS Mobile	about 1 month ago	about 1 month ago
Punch Digital Agency	about 1 month ago	about 1 month ago
Anaplan, Inc.	about 1 month ago	about 1 month ago
thredUP	about 1 month ago	about 1 month ago
Equilar	about 1 month ago	about 1 month ago
Vida & Co - Software Engineer - Full Stack	about 1 month ago	about 1 month ago
Advanced Microgrid Solutions	about 1 month ago	about 1 month ago
shippo	about 1 month ago	about 1 month ago
Handshake	about 1 month ago	about 1 month ago
Split Software	about 1 month ago	about 1 month ago
LiveRamp	about 1 month ago	about 1 month ago
Fingerprint	about 1 month ago	about 1 month ago
StyleSeat	about 1 month ago	about 1 month ago
Numerate Inc	about 1 month ago	about 1 month ago
Airbnb - Software Engineer, China Growth	about 1 month ago	about 1 month ago
Purely HR	about 1 month ago	about 1 month ago
LifeAssist	about 1 month ago	about 1 month ago
Punch Agency	about 1 month ago	about 1 month ago
Color Genomics	about 1 month ago	about 1 month ago
Anaplan UI/Frontend Developer	about 1 month ago	about 1 month ago
Web IRhythm	about 1 month ago	about 1 month ago
Pillow	about 1 month ago	about 1 month ago
Elements Analytics	about 1 month ago	about 1 month ago
Chartboost	about 1 month ago	about 1 month ago
Numerate, Inc	about 1 month ago	about 1 month ago
Foodspotting - Ruby on Rails Developer	about 1 month ago	about 2 months ago
Fingerprint Co. - Full Stack Engineer	about 1 month ago	about 2 months ago
Unity Technologies - Junior Engineer	about 1 month ago	about 2 months ago
Arena	about 1 month ago	about 2 months ago
Ideator	about 1 month ago	about 2 months ago
Forio	about 1 month ago	about 2 months ago
Malwarebytes - Front End	about 1 month ago	about 2 months ago
Modsy - Front-End Developer	about 1 month ago	about 2 months ago
Leanplum - Front End Web Developer	about 1 month ago	about 2 months ago
SumoLogic	about 1 month ago	about 2 months ago
BuildZoom	about 1 month ago	about 2 months ago
Nazama Management Services	about 1 month ago	about 2 months ago
EarnUp	about 1 month ago	about 2 months ago
VolunteerMatch	about 1 month ago	about 2 months ago
Compas technology	about 1 month ago	about 2 months ago
Epik	about 1 month ago	about 2 months ago
AllianceIT	about 1 month ago	about 1 month ago
Frankly - Software Engineer (Software Front-end)	about 1 month ago	about 1 month ago
Gladly	about 1 month ago	about 1 month ago
Common Sense Media - Front End Developer	about 1 month ago	about 1 month ago
pubnub	about 1 month ago	about 1 month ago
affinity - frontend	about 1 month ago	about 1 month ago
Tynker	about 1 month ago	about 1 month ago
HighFive - Web Developer	about 1 month ago	about 1 month ago
Flexton, Inc. - Ruby on Rails Full Stack Developer	about 1 month ago	about 1 month ago
Surya Financial Systems Inc - JavaScript Developer	about 1 month ago	about 1 month ago
Narvar	about 1 month ago	about 1 month ago
Tanisha	about 1 month ago	about 1 month ago
AltSchool - Frontend Software Engineer	about 1 month ago	about 1 month ago
GenapSys - Frontend	about 1 month ago	about 1 month ago
Motionloft	about 1 month ago	about 1 month ago
Tumblr	about 1 month ago	about 1 month ago
Gumroad - Front-end Engineer	about 1 month ago	about 1 month ago
Sindeo - Front End Developer	about 1 month ago	about 1 month ago
Turn - Software Engineer, Distributed Systems	about 1 month ago	about 1 month ago
Moovweb - Full Stack Engineer	about 1 month ago	about 1 month ago
24-Hour HR Process Outsourcing Inc	about 1 month ago	about 1 month ago
Electron-Beam Lithography	about 1 month ago	about 1 month ago
ChargePoint, Inc.	about 1 month ago	about 1 month ago
dpix, LLC	about 1 month ago	about 1 month ago
Artizen	about 1 month ago	about 1 month ago
Mavrx	about 1 month ago	about 1 month ago
Hudson Paradise - Software Engineer	about 1 month ago	about 1 month ago
CloudFlare	about 1 month ago	about 1 month ago
Broadly - Frontend Engineer	about 1 month ago	about 1 month ago
Danta technologies	about 1 month ago	about 1 month ago
Park Computer Systems	about 1 month ago	about 1 month ago
etouch	about 1 month ago	about 1 month ago
Atomic - Front End Engineer	about 1 month ago	about 1 month ago
HealthRight	about 1 month ago	about 1 month ago
Remind - Javascript Engineer	about 1 month ago	about 1 month ago
ubm - web dev	about 2 months ago	about 2 months ago
Zoosk	about 2 months ago	about 2 months ago
Vesper	about 2 months ago	about 2 months ago
Ancestry.com - Software Developer	about 2 months ago	about 2 months ago
Viki - front end web developer	about 2 months ago	about 2 months ago
Crushpath - Front-End Engineer	about 2 months ago	about 2 months ago
Parkside Lending	about 2 months ago	about 2 months ago
StichFix	about 2 months ago	about 2 months ago
Snackoo Inc	about 2 months ago	about 2 months ago
Hoodline	about 2 months ago	about 2 months ago
Bleacher Report	about 2 months ago	about 2 months ago
Nuna	about 2 months ago	about 2 months ago
Scribd	about 2 months ago	about 2 months ago
doubletwist	about 2 months ago	about 2 months ago
Doximity - Software Engineer	about 2 months ago	about 2 months ago
Aspera- Software Engineer	about 2 months ago	about 2 months ago
Weather Underground	about 2 months ago	about 2 months ago
EasyPost - Frontend Engineer	about 2 months ago	about 2 months ago
sony playstation - infrastructure automation developer	about 2 months ago	about 2 months ago
Carrot Sense Inc	about 2 months ago	about 2 months ago
Baytech Interactive Web Solutions	about 2 months ago	about 2 months ago
Ma Labs, Inc.	about 2 months ago	about 2 months ago
INSzoom	about 2 months ago	about 2 months ago
Endicia	about 2 months ago	about 2 months ago
VNYL	about 2 months ago	about 2 months ago
CV Hires	about 2 months ago	about 2 months ago
Go-Live Labs	about 2 months ago	about 2 months ago
Lime Recruit	about 2 months ago	about 2 months ago
Perfict Global, Inc	about 2 months ago	about 2 months ago
Wonderware Norcal	about 2 months ago	about 2 months ago
Zone24x7 Inc	about 2 months ago	about 2 months ago
Rangam Consultant Inc	about 2 months ago	about 2 months ago
Confidential - Front End Developer	about 2 months ago	about 2 months ago
GrayMeta Inc	about 2 months ago	about 2 months ago
Kyocera	about 2 months ago	about 2 months ago
DiCon Fiberoptics, Inc	about 2 months ago	about 2 months ago
tubular	about 2 months ago	about 2 months ago
Vida	about 2 months ago	about 2 months ago
Confidential	about 2 months ago	about 2 months ago
VI Shots LLC	about 2 months ago	about 2 months ago
Orange Enterprises, Inc	about 2 months ago	about 2 months ago
Three's Tech LLC UI/UX Designer	about 2 months ago	about 2 months ago
QT Ultrasound Labs	about 2 months ago	about 2 months ago
Hire IT People Inc.	about 2 months ago	about 2 months ago
Feral Innovations	about 2 months ago	about 2 months ago
Pinnacle Soft	about 2 months ago	about 2 months ago
Stefanini - Software Developer III	about 2 months ago	about 2 months ago
Grassbridge	about 2 months ago	about 2 months ago
inSync Staffing	about 2 months ago	about 2 months ago
Multifamily Property Management Company	about 2 months ago	about 2 months ago
Magenic	about 2 months ago	about 2 months ago
Nearshore Systems - Talent	about 2 months ago	about 2 months ago
Technology Resource Network	about 2 months ago	about 2 months ago
HSF Consulting	about 2 months ago	about 2 months ago
NVXL Technology	about 2 months ago	about 2 months ago
Worldlink	about 2 months ago	about 2 months ago
Western Office	about 2 months ago	about 2 months ago
Rockridge Group - Front End Engineer	about 2 months ago	about 2 months ago
Launch Consulting Group - Front End Engineer	about 2 months ago	about 2 months ago
IntelliSoft Technologies	about 2 months ago	about 2 months ago
Jayway	about 2 months ago	about 2 months ago
Tubular Labs - Full Stack Software Engineer	about 2 months ago	about 2 months ago
connectrex corp	about 2 months ago	about 2 months ago
systematics agency	about 2 months ago	about 2 months ago
Interpro, Inc	about 2 months ago	about 2 months ago
SiliconHire LLC	about 2 months ago	about 2 months ago
Full Stack Engineer E-infotek	about 2 months ago	about 2 months ago
Java Engineer Cloud IQ Technologies Inc	about 2 months ago	about 2 months ago
QuantumScape	about 2 months ago	about 2 months ago
Tailored Brands	about 2 months ago	about 2 months ago
Sherman Clay -Application Developer-587-504	about 2 months ago	about 2 months ago
Sherman Clay	about 2 months ago	about 2 months ago
Vida - Software Engineer, full stack	about 2 months ago	about 2 months ago
efabless.com Software Engineer (Full Stack WEb Development) - Remote Position	about 2 months ago	about 2 months ago
Full Stack Developer Cyber Security Startup In Mountain View, CA, USA	about 2 months ago	about 2 months ago
Macate	about 2 months ago	about 2 months ago
Third Eye Consulting Services	about 2 months ago	about 2 months ago
DataGlance, Inc. - Web Developer	about 2 months ago	about 2 months ago
Teema Solutions Group	about 2 months ago	about 2 months ago
Ziprecruiter - confidential front end developer - sf	about 2 months ago	about 2 months ago
Machaw.com	about 2 months ago	about 2 months ago
Akorbi	about 2 months ago	about 2 months ago
E-Infotek	about 2 months ago	about 2 months ago
Sohum Inc	about 2 months ago	about 2 months ago
SymphonyTeleca	about 2 months ago	about 2 months ago
EE-Recruiters	about 2 months ago	about 2 months ago
OpenVPN	about 2 months ago	about 2 months ago
rfXcel	about 2 months ago	about 2 months ago
Hudson Paradise LLC	about 2 months ago	about 2 months ago
RiverRock Network Jave Engineer	about 2 months ago	about 2 months ago
Web Application Developer Akorbi	about 2 months ago	about 2 months ago
UI Engineer Tailored Brands	about 2 months ago	about 2 months ago
Front End Application Engineer Rangam Consultant Inc	about 2 months ago	about 2 months ago
Web Developer Multifamily Property Management Company	about 2 months ago	about 2 months ago
Application Developer-587-504 Sherman Clay	about 2 months ago	about 2 months ago
SalesForce Developer Strategic Staffing Solutions (S3) - Concord, CA	about 2 months ago	about 2 months ago
Javascript Application / Game Developer Smart Sparrow	about 2 months ago	about 2 months ago
Lead Web Developer â€“ Web Architect Baytech Interactive Web Solutions - San Jose, CA	about 2 months ago	about 2 months ago
ScImage, Inc	about 2 months ago	about 2 months ago
Go-Live Labs - UI Developer / Front End Engineer	about 2 months ago	about 2 months ago
Resolute Staffing	about 2 months ago	about 2 months ago
Techone	about 2 months ago	about 2 months ago
Talener Andriod Developer	about 2 months ago	about 2 months ago
loandepot	3 days ago	3 days ago
Hero.jobs	3 days ago	3 days ago
Inwerks	3 days ago	3 days ago
